1 1 1 1 1 9 9 9 9 10 9 1 1 1 1 1 1 1
1 0 0 1 0 9 0 0 0 0 0 9 13 13 2 13 13 1
1 0 0 1 6 9 0 9 0 0 0 9 13 0 0 0 13 1
1 0 0 0 0 9 0 4 0 0 0 4 13 0 0 0 13 1
7 0 0 0 0 0 0 9 0 0 0 9 13 0 0 0 13 1
1 0 0 0 0 9 9 9 4 8 4 9 13 13 0 0 13 1
1 0 0 0 0 11 11 3 3 11 11 13 0 0 0 0 13 1
1 0 0 0 0 11 0 0 0 0 0 11 2 0 0 0 13 1
1 0 0 0 0 0 0 0 0 0 0 11 0 0 0 0 13 1
1 0 0 0 0 11 0 0 0 0 0 0 0 0 0 0 13 1
1 1 7 1 1 11 11 11 11 11 11 11 13 13 13 13 13 13